110000000000000000000000000000000000000000000000000000000000000000000000000000000000000000000000000000000000000000000011
110000000000000000000000000000000000000000000000000000000000000000000000000000000000000000000000000000000000000000000011
110000000000000000000000000000000000000000000000000000000000000000000000000000000000000000000000000000000000000000000011
110000000000000000000000000000000000000000000000000000000000000000000000000000000000000000000000000000000000000000000011
110000000000000000000000000000000000000000000000000000000000000000000000000000000000000000000000000000000000000000000011
110000000000000000000000000000000000000000000000000000000000000000000000000000000000000000000000000000000000000000000011
110000000000000000000000000000000000000000000000000000000000000000000000000000000000000000000000000000000000000000000011
110002222200000000000000000000000000000000000002222222222222000000000000000000000000000000000000000000000000000000000011
110000000022000000000000000000022222222222000000000000000000222000002222222200000000000000000000222222200000000000000011
110000000000000000000000000000000000000000000000000000000000000000000000000020000000000000000000000000000000000000000011
110000000000000022222222222220000000000000000000000000000000000000000000000000002222220000000000000000000000000000000011
110000000000000000000000000000000000000000000000000000000000000000000000000000000000000000000000000000000000000000000011
110000000000000000000000000000000000000002222222222222000000000000000000000000000000000000000000000000222222000000000011
110000000000000000000000000000000000000000000000000000000000000000000000022222222222220000000000000000000000000000000011
110000000000002222222200000000000000000000000000000000000000000000000000000000000000000000000000000000000000000000000011
110000000000000000000000000000000000000000000000000000000000000000222200000000000000000000000000000000000000000000000011
110000000000000000000000000000000000000000000002222222222200000000111100000000000000000000000000000000000000000000000011
112222222222222222222222222222222222222222222221111111111122222222111122222222222222222222222222222222222222222222222211
111111111111111111111111111111111111111111111111111111111111111111111111111111111111111111111111111111111111111111111111
111111111111111111111111111111111111111111111111111111111111111111111111111111111111111111111111111111111111111111111111
111111111111111111111111111111111111111111111111111111111111111111111111111111111111111111111111111111111111111111111111
111111111111111111111111111111111111111111111111111111111111111111111111111111111111111111111111111111111111111111111111
111111111111111111111111111111111111111111111111111111111111111111111111111111111111111111111111111111111111111111111111
111111111111111111111111111111111111111111111111111111111111111111111111111111111111111111111111111111111111111111111111
111111111111111111111111111111111111111111111111111111111111111111111111111111111111111111111111111111111111111111111111
111111111111111111111111111111111111111111111111111111111111111111111111111111111111111111111111111111111111111111111111